




111111111111111111111111111111111111111
100C100C100C100C100C100C100C100C100C101
10100C100C100C100C100C100C100C100C100C1
111111111111111111111111111111111111101
100C100C100C100C100C100C100C100C100C101
1C100C100C100C100C100C100C100C100C100C1
100000000000000000000000000000000000011
100C100C100C100C100C100C100C100C100C101
1C100C100C100C100C100C100C100C100C100C1
111111111111111111111111111111111111101
100C100C100C100C100C100C100C100C100C101
1C100C100C100C100C100C100C100C100C100C1
100000000000E00000000000000000000000011
100C100C100C100C000C100C100C100C100C101
1C100C100C100C000C000C100C100C100C100C1
110000000000000000000000000000000000101
100C100C100CC00C000C000C100C100C000C101
1C100C100C10PC100C100C1000000C100C100C1
111111111111111111111111111111111111111





