1111111111111111
1E01000000001C01
1111111100001111
1000100100000001
100011P100000001
1111111111111111